Columns: 40
Rows: 22
2323232323232323232323232323232323232323
4545454545454545454545454545454545454545
2300000000002300000000000000002300000000
4500000000104500066666666666004500000000
2300000000002300066666666666000000100000
4500000000004500066666666666000000000000
2300000000002300066666666666002300000000
4500000000004500066666666666004500000023
2300000000002301066666666666002300010045
4500000011114500000000000000004500000023
2300000001112301110000000000002300000045
4500000000114501000000000000004500000023
2300000000002301100000000000002300000045
4500000000104500000666666600004500000000
2300100000000010000666666600002300100000
4500000000000000000666666600004500000000
2300000000002300000666666600002300000066
4500000000004500000000000000004500000000
2323232323232323232323232323002323232323
4545454545454545454545454545004545454545
2323232323232323232323232300002323232323
4545454545454545454545454500004545454545
